14 14 14 14 14 14 14 14 14 14 14 14 14 
14 5 14 5 14 5 14 5 14 5 14 5 14 
14 14 14 14 14 14 14 14 14 14 14 14 14 
14 14 14 14 14 14 14 14 14 14 14 14 14 
14 0 14 0 14 0 14 0 14 0 14 0 14 
14 14 14 14 14 14 14 14 14 14 14 14 14 
14 14 14 14 14 14 14 14 14 14 14 14 14 
14 8 14 8 14 8 14 8 14 8 14 8 14 
14 14 14 14 14 14 14 14 14 14 14 14 14 
14 14 14 14 14 14 14 14 14 14 14 14 14 
14 0 14 0 14 14 14 14 14 0 14 0 14 
14 14 14 14 14 0 0 0 14 14 14 14 14 
14 14 14 14 14 0 13 0 14 14 14 14 14 
